[nivel]
origen=terrenogen.png
corte_ancho=32
corte_alto=32
mapa=...i....#.......................
     ...i....#.......................
     ...i....#.......................
     ...i#####.......................
     ................................
     ................................
     ................................
     ................................
     ................................
     ................................
     ................................
     ................................
     ................................
     ................................
     ................................
     ................................
     ................................
     ................................
     ................................
     ................................

[.]
nombre=pasto
x=16
y=0
bloqueo=0   #colision
dam=0       #daño

[#]
nombre=cercodu
x=19
y=1
bloqueo=1
dam=3

[i]
nombre=cercoi
x=18
y=2
bloqueo=1
dam=2
